................-
................-
................-
................-
................-
................-
................-
................-
................-
................-
................-
................-
...............#-
####..........##-
#............###-
################-