................-
................-
................-
................-
................-
................-
................-
................-
................-
................-
................-
....########....-
................-
####........####-
................-
################-