................-
................-
................-
................-
..############..-
..#..........#..-
..#...#..#...#..-
..#.#......#.#..-
..#..######..#..-
..#..........#..-
..############..-
................-
................-
................-
................-
................-