################-
#..............#-
#..............#-
#..............#-
#..............#-
#..............#-
#..............#-
#..............#-
#..............#-
#..............#-
#..............#-
#..............#-
#......#########-
#..............#-
#..............#-
################-